111111111111111
10010000000C001
100001111100001
1P0011E00000001
100000000000001
100011111100001
101010101010101
111111111111111